report_date,pcr_neg,pcr_pos,pcr_int,pcr_total,pcr_avg
2020-03-16,409,30,0,439,NA
2020-03-17,635,50,0,685,NA
2020-03-18,738,57,2,797,NA
2020-03-19,1055,73,1,1129,NA
2020-03-20,1078,101,2,1181,NA
2020-03-21,741,82,2,825,NA
2020-03-22,626,79,0,705,823
2020-03-23,1630,176,4,1810,1018.8571428571429
2020-03-24,1850,214,0,2064,1215.857142857143
2020-03-25,2221,224,6,2451,1452.142857142857
2020-03-26,2172,259,1,2432,1638.2857142857142
2020-03-27,1884,295,0,2179,1780.857142857143
2020-03-28,1092,194,1,1287,1846.857142857143
2020-03-29,751,138,0,889,1873.142857142857
2020-03-30,2429,361,0,2790,2013.142857142857
2020-03-31,2204,301,1,2506,2076.285714285714
2020-04-01,2046,274,2,2322,2057.8571428571427
2020-04-02,1889,290,4,2183,2022.2857142857142
2020-04-03,1733,250,2,1985,1994.5714285714287
2020-04-04,952,146,2,1100,1967.857142857143
2020-04-05,784,113,3,900,1969.4285714285713
2020-04-06,2417,320,7,2744,1962.857142857143
2020-04-07,2081,242,2,2325,1937
2020-04-08,2060,252,1,2313,1935.7142857142858
2020-04-09,1766,218,4,1988,1907.857142857143
2020-04-10,1986,241,5,2232,1943.142857142857
2020-04-11,851,107,1,959,1923
2020-04-12,694,102,3,799,1908.5714285714287
2020-04-13,1978,287,4,2269,1840.7142857142858
2020-04-14,1966,234,6,2206,1823.7142857142858
2020-04-15,1844,242,4,2090,1791.857142857143
2020-04-16,1846,235,4,2085,1805.7142857142858
2020-04-17,2177,201,4,2382,1827.142857142857
2020-04-18,1084,173,0,1257,1869.7142857142858
2020-04-19,831,151,2,984,1896.142857142857
2020-04-20,2460,317,10,2787,1970.142857142857
2020-04-21,2301,275,9,2585,2024.2857142857142
2020-04-22,2710,278,6,2994,2153.4285714285716
2020-04-23,2657,280,9,2946,2276.4285714285716
2020-04-24,2481,263,17,2761,2330.5714285714284
2020-04-25,1180,140,1,1321,2339.714285714286
2020-04-26,1051,90,1,1142,2362.285714285714
2020-04-27,3790,351,7,4148,2556.714285714286
2020-04-28,4574,431,14,5019,2904.4285714285716
2020-04-29,4620,379,9,5008,3192.1428571428573
2020-04-30,3868,337,11,4216,3373.5714285714284
2020-05-01,4242,339,13,4594,3635.4285714285716
2020-05-02,1587,91,2,1680,3686.714285714286
2020-05-03,1101,89,2,1192,3693.8571428571427
2020-05-04,3872,304,14,4190,3699.8571428571427
2020-05-05,4636,327,17,4980,3694.285714285714
2020-05-06,4091,258,8,4357,3601.285714285714
2020-05-07,3786,182,10,3978,3567.285714285714
2020-05-08,4408,178,6,4592,3567
2020-05-09,2146,133,4,2283,3653.1428571428573
2020-05-10,1267,76,0,1343,3674.714285714286
2020-05-11,5082,263,11,5356,3841.285714285714
2020-05-12,5280,235,7,5522,3918.714285714286
2020-05-13,5376,342,9,5727,4114.428571428572
2020-05-14,4880,265,4,5149,4281.714285714285
2020-05-15,5708,255,14,5977,4479.571428571428
2020-05-16,3890,100,2,3992,4723.714285714285
2020-05-17,2771,125,3,2899,4946
2020-05-18,6479,282,6,6767,5147.571428571428
2020-05-19,5826,299,6,6131,5234.571428571428
2020-05-20,5841,306,5,6152,5295.285714285715
2020-05-21,5623,321,9,5953,5410.142857142857
2020-05-22,6929,251,9,7189,5583.285714285715
2020-05-23,2995,109,2,3106,5456.714285714285
2020-05-24,2462,82,3,2547,5406.428571428572
2020-05-25,2363,94,2,2459,4791
2020-05-26,12717,364,13,13094,5785.714285714285
2020-05-27,11592,360,9,11961,6615.571428571428
2020-05-28,10310,271,7,10588,7277.714285714285
2020-05-29,9521,272,7,9800,7650.714285714285
2020-05-30,4342,324,4,4670,7874.142857142857
2020-05-31,2779,216,3,2998,7938.571428571428
2020-06-01,10169,354,81,10604,9102.142857142857
2020-06-02,8530,284,13,8827,8492.57142857143
2020-06-03,8818,281,10,9109,8085.142857142857
2020-06-04,7713,310,18,8041,7721.285714285715
2020-06-05,8726,321,10,9057,7615.142857142857
2020-06-06,3373,125,3,3501,7448.142857142857
2020-06-07,2339,81,0,2420,7365.571428571428
2020-06-08,9585,366,9,9960,7273.571428571428
2020-06-09,10194,385,2,10581,7524.142857142857
2020-06-10,9999,379,10,10388,7706.857142857143
2020-06-11,10496,618,8,11122,8147
2020-06-12,8496,389,10,8895,8123.857142857143
2020-06-13,3838,172,5,4015,8197.285714285714
2020-06-14,2607,124,1,2732,8241.857142857143
2020-06-15,13930,520,44,14494,8889.57142857143
2020-06-16,11694,573,114,12381,9146.714285714286
2020-06-17,9846,514,20,10380,9145.57142857143
2020-06-18,9554,663,41,10258,9022.142857142857
2020-06-19,10550,491,18,11059,9331.285714285714
2020-06-20,4489,258,11,4758,9437.42857142857
2020-06-21,2902,234,0,3136,9495.142857142857
2020-06-22,15713,722,93,16528,9785.714285714286
2020-06-23,11994,674,26,12694,9830.42857142857
2020-06-24,11311,750,29,12090,10074.714285714286
2020-06-25,9747,664,16,10427,10098.857142857143
2020-06-26,12034,667,10,12711,10334.857142857143
2020-06-27,5666,424,3,6093,10525.57142857143
2020-06-28,4655,295,2,4952,10785
2020-06-29,17950,1005,33,18988,11136.42857142857
2020-06-30,14630,1017,16,15663,11560.57142857143
2020-07-01,13917,1088,24,15029,11980.42857142857
2020-07-02,13100,1104,14,14218,12522
2020-07-03,8371,738,14,9123,12009.42857142857
2020-07-04,3709,354,6,4069,11720.285714285714
2020-07-05,4076,378,0,4454,11649.142857142857
2020-07-06,16798,1305,13,18116,11524.57142857143
2020-07-07,16467,1383,19,17869,11839.714285714286
2020-07-08,16078,1485,22,17585,12204.857142857143
2020-07-09,15573,1357,40,16970,12598
2020-07-10,15086,1301,36,16423,13640.857142857143
2020-07-11,8907,726,29,9662,14439.857142857143
2020-07-12,5838,497,7,6342,14709.57142857143
2020-07-13,20931,1554,55,22540,15341.57142857143
2020-07-14,18357,1516,34,19907,15632.714285714286
2020-07-15,16690,1337,22,18049,15699
2020-07-16,13905,1244,14,15163,15440.857142857143
2020-07-17,15026,1202,15,16243,15415.142857142857
2020-07-18,7567,767,15,8349,15227.57142857143
2020-07-19,5028,561,12,5601,15121.714285714286
2020-07-20,20390,1727,31,22148,15065.714285714286
2020-07-21,16857,1470,35,18362,14845
2020-07-22,13846,1424,22,15292,14451.142857142857
2020-07-23,14423,1417,37,15877,14553.142857142857
2020-07-24,14795,1326,27,16148,14539.57142857143
2020-07-25,7681,652,10,8343,14538.714285714286
2020-07-26,5434,495,15,5944,14587.714285714286
2020-07-27,18933,1557,40,20530,14356.57142857143
2020-07-28,17866,1359,30,19255,14484.142857142857
2020-07-29,14078,1443,28,15549,14520.857142857143
2020-07-30,12906,1250,19,14175,14277.714285714286
2020-07-31,13458,1130,10,14598,14056.285714285714
2020-08-01,7323,612,20,7955,14000.857142857143
2020-08-02,5437,618,22,6077,14019.857142857143
2020-08-03,20414,1675,43,22132,14248.714285714286
2020-08-04,16836,1430,27,18293,14111.285714285714
2020-08-05,14570,1365,19,15954,14169.142857142857
2020-08-06,13719,1143,12,14874,14269
2020-08-07,14087,1111,20,15218,14357.57142857143
2020-08-08,6739,694,10,7443,14284.42857142857
2020-08-09,5203,471,9,5683,14228.142857142857
2020-08-10,17560,1463,20,19043,13786.857142857143
2020-08-11,15806,1286,25,17117,13618.857142857143
2020-08-12,14086,1380,29,15495,13553.285714285714
2020-08-13,13085,1128,17,14230,13461.285714285714
2020-08-14,13785,1117,15,14917,13418.285714285714
2020-08-15,6182,616,10,6808,13327.57142857143
2020-08-16,4963,533,14,5510,13302.857142857143
2020-08-17,14782,1488,26,16296,12910.42857142857
2020-08-18,15126,1198,17,16341,12799.57142857143
2020-08-19,13247,1219,20,14486,12655.42857142857
2020-08-20,12193,1207,17,13417,12539.285714285714
2020-08-21,12291,1069,12,13372,12318.57142857143
2020-08-22,5566,545,9,6120,12220.285714285714
2020-08-23,3969,504,15,4488,12074.285714285714
2020-08-24,14590,1488,27,16105,12047
2020-08-25,13837,1344,23,15204,11884.57142857143
2020-08-26,12553,1439,22,14014,11817.142857142857
2020-08-27,12802,1279,17,14098,11914.42857142857
2020-08-28,11752,1240,23,13015,11863.42857142857
2020-08-29,6018,679,12,6709,11947.57142857143
2020-08-30,4244,537,7,4788,11990.42857142857
2020-08-31,13807,1631,37,15475,11900.42857142857
2020-09-01,13322,1422,21,14765,11837.714285714286
2020-09-02,13624,1456,32,15112,11994.57142857143
2020-09-03,14110,1315,61,15486,12192.857142857143
2020-09-04,14003,1294,14,15311,12520.857142857143
2020-09-05,6501,720,8,7229,12595.142857142857
2020-09-06,4928,584,35,5547,12703.57142857143
2020-09-07,5820,650,5,6475,11417.857142857143
2020-09-08,19112,1942,37,21091,12321.57142857143
2020-09-09,14394,1812,30,16236,12482.142857142857
2020-09-10,14112,1479,17,15608,12499.57142857143
2020-09-11,14963,1394,24,16381,12652.42857142857
2020-09-12,6804,712,5,7521,12694.142857142857
2020-09-13,5349,586,5,5940,12750.285714285714
2020-09-14,20083,1829,36,21948,14960.714285714286
2020-09-15,17884,1684,32,19600,14747.714285714286
2020-09-16,14529,1525,14,16068,14723.714285714286
2020-09-17,14536,1566,21,16123,14797.285714285714
2020-09-18,14169,1390,14,15573,14681.857142857143
2020-09-19,7430,753,18,8201,14779
2020-09-20,4517,594,3,5114,14661
2020-09-21,17868,1788,34,19690,14338.42857142857
2020-09-22,15470,1404,24,16898,13952.42857142857
2020-09-23,13166,1434,19,14619,13745.42857142857
2020-09-24,7527,894,11,8432,12646.714285714286
